--------------------------------------------------------------------------------------------------------------------------------------------------
|________________________________________________________________________________________________________________________________________________|
|__________________________________________AXXXXXXXXXXXXXXXXXXXXXXXB_____________________________________________________________________________|
|__________________________________________axxxxxxxxxxxxxxxxxxxxxxxb_____________________________________________________________________________|
|__________________________________________\                       /_____________________________________________________________________________|
|__________________________________________\                       /_____________________________________________________________________________|
|__________________________________________cd                    CyD_____________________________________________________________________________|
|___________________________________________\                    /_______________________________________________________________________________|
|___________________________________________\                    /_______________________________________________________________________________|
|__________AXXXXXXB_____________________AXXXF                    EXB_____________________________________________________________________________|
|__________axxxxxxb_____________________axxxf                    exb_____________________________________________________________________________|
|__________\      /_____________________\                          /__________________________________AXXXXXXXXXXXXXXXXXXXXXXXXXXXXXB____________|
|___AXXXXXXF      /_____________________cyd                        /__________________________________axxxxxxxxxxxxxxxxxxxxxxxxxxxxxb____________|
|___axxxxxxf      EXXXXXB_________________\                        /__________________________________\                             /____________|
|___\             exxxxxb_________________\                        EXXXB_____________________AXXXXXXXXF                             /____________|
|___\                   /_________________\                        exxxb_____________________axxxxxxxxf                             /____________|
|___\                   /_________________cyyyyyd                      /_____________________\                                      /____________|
|___\        M          EXXXXXXXXXXB____________\                      /___________AXXXXXXXXXF                               CyyyyyyD____________|
|___\                   exxxxxxxxxxb____________\                      /___________axxxxxxxxxf                               /___________________|
|___\                              /____________cyyyyyyd       CyyyyyyyD___________\                                         /___________________|
|___\                              /___________________\       /___________________\                                         EXXXXXXXXXXXXXXXXB__|
|___\                              /___________________\       /________________AXXF           M                             exxxxxxxxxxxxxxxxb__|
|___cyyyyyyyyd              CyyyyyyD___________________\       /________________axxf                                                          /__|
|____________\              /__________________________\       /________________\                                                             /__|
|____________\              EXXXXXXXXXXXXXXXXXXXXXXXXXXF       EXXXXXXXXXXXXXXXXF                                                             /__|
|____________\              exxxxxxxxxxxxxxxxxxxxxxxxxxf       exxxxxxxxxxxxxxxxf                                                             /__|
|____________\                                                                                                                                /__|
|____________\                                                                                                                                /__|
|____________\                          Cyyyyyyyyyyyyyyd       Cyyyyyyyyyyyyyyyyyyyyyyyyyyyyyyd                         CyyyyyyyyyyyyyyyyyyyyyD__|
|____________\                          /______________\       /______________________________\                         /________________________|
|____________\                          /______________\       /______________________________\                         /________________________|
|__AXXXXXXXXXF                          /______________\       /_______________________AXXXXXXF                         /________________________|
|__axxxxxxxxxf             CyyyyyyyyyyyyD______________\       /_______________________axxxxxxf                         /________________________|
|__\                       /_________________AXXXXXXXXXF       EXXXXXXXXXB_____________\                                /________________________|
|__\                       /_________________axxxxxxxxxf       exxxxxxxxxb_____________\                    CyyyyyyyyyyyD________________________|
|__\                       /_________________\                           /_____________\                    /____________________________________|
|__\                       /_________________\                           /_____________cyyyyyyyyyyyyyyyyyyyyD____________________________________|
|__cyyyyyyyyyyyyyyyyyyyyyyyD_________________\                           /_______________________________________________________________________|
|____________________________________________\                           /_________________AXXXXXXXXXXXXXXXXXXXXXXXXXXB__________________________|
|_____________AXXXXXXXXXXXXXXXXXXXXXB________\                           /_________________axxxxxxxxxxxxxxxxxxxxxxxxxxb__________________________|
|_____________axxxxxxxxxxxxxxxxxxxxxb________cyyyyyyyyyd       CyyyyyyyyyD_________________\                          /__________________________|
|_____________\                     /__________________\       /___________________________\                          /__________________________|
|_____________\                     /__________________\       /___________________________\                          /__________________________|
|_____________cyyyyyd            CyyD__________________\       /_________AXXXXXXXXB________\                          /__________________________|
|___________________\            /_____________________\       /_________axxxxxxxxb________cyyyyyyyyd             CyyyD__________________________|
|___________________\            /_____________________\       /_________\        /_________________\             /______________________________|
|____AXXXXXXXXXXXXXXF            EXXXXXXXXXXXXXXXXXXXXXF       EXXXXXXXXXF        EXXXXXXXXXXXXXXXXXF             EXXXXXXXXXB____________________|
|____axxxxxxxxxxxxxxf            exxxxxxxxxxxxxxxxxxxxxf       exxxxxxxxxf        exxxxxxxxxxxxxxxxxf             exxxxxxxxxb____________________|
|____\                                                                                                                      /____________________|
|____\                                                                                                                      /____________________|
|____\                                                                                                                      /____________________|
|____\                                                                                                                      /____________________|
|____\                                                                                                                      /____________________|
|____\                                                                                                                      /____________________|
|____\                                                                                                                      /____________________|
|____\                                                                                                                      /____________________|
|____\                                                                                                                      /____________________|
|____cyyd            Cyyyyyyyyyyyyyyyyyyd     Cyyyyyyyyyyd  Cyyyyyyyyyyyyyyyyyyyyd             Cyyyyyyyyyyyyd        CyyyyyyD____________________|
|_______\            /__________________\     /__________\  /____________________\             /____________\        /___________________________|
|_______\            /__________________\     /__________\  /___________________AF             EB___________\        EXXXB_______________________|
|____AXXF            EXXXXXXB________AXXF     /__________\  /___________________af             eb___________\        exxxb_______________________|
|____axxf            exxxxxxb________axxf     /__________\  /___________________\               /___________\            /_______________________|
|____\                      /________\        /__________\  /___________________cyyyyyyyyyyyyyyyD___________\            /_______________________|
|____\                      /________cyyyyyyyyD__________\  /_______________________________________________cyyyyyyyyyyyyD_______________________|
|____\                      /____________________________\  /____________________________________________________________________________________|
|____cyyyyyyyyyyyyyyyyyyyyyyD_______________________AXXXXF  EXXXB________________________________________________________________________________|
|___________________________________________________axxxxf  exxxb________________________________________________________________________________|
|___________________________________________________\           /________________________________________________________________________________|
|_________________________________________________AXF           EXB______________________________________________________________________________|
|_________________________________________________axf           exb______________________________________________________________________________|
|_________________________________________________\               /______________________________________________________________________________|
|_____________________________________________AXXXF               EXXXB__________________________________________________________________________|
|_____________________________________________axxxf               exxxb__________________________________________________________________________|
|_____________________________________________\           O           /__________________________________________________________________________|
|_____________________________________________\                       /__________________________________________________________________________|
|_____________________________________________\                       /__________________________________________________________________________|
|_____________________________________________\                       /__________________________________________________________________________|
|_____________________________________________\                       /__________________________________________________________________________|
|_____________________________________________cyyyyyyyyyyyyyyyyyyyyyyyD__________________________________________________________________________|
|________________________________________________________________________________________________________________________________________________|
--------------------------------------------------------------------------------------------------------------------------------------------------
